P2 . # S # . . me 
. . # S # . . P2
P2 . # S # . . .
. . # S # . . P2
P2 . # S # . . .
. . # S # . . P2
P2 . # S # . . .
L . # S # . . P2