L . # # # # # . P2 P2 # #
. . # . . . . . # S # .
. # # . # # # . # # # .
. . . . . . # . # . # .
# # . # # # # . # . # .
. # . # . . . . . . . .
. # . # # # # # # # # #
. # . . . . . . . . . .
. # # . # # . # # # # .
. . . . . # . # S # # #
S # . # # # . # . # # #
. # # # . . . . . # # m