me # # . # # . # # . # me
. . . . . . . . . . . .
# # . # # . # # . # # .
. . . . . . . . . . . .
. # # . # # . # # . # #
me . . . . . . . . . . me
# # . # # . # # . # # .
. . . . . . . . . . . .
. . . . . . . . . . . .
. . . . . . . . . . . .
me . . . . . . . . . . .
L . . . . . . . . . . me