L . # # # # # # # # # #
. . . # S . . # . . . #
# # # # . # # # . # # .
. . # . . # . # . # . .
# . # # . # # # . S # #
# . # . . # . . . # # #
# # . # # # . # # # # #
. . . . S . # . . . . #
# # # # . # # # # . # #
. . . # # # . # # . . #
. # S # . . . # D2 # # m
. # # # # # # . . # . m