. . # . # . . . 
. # . # . # . #
# . # . # . # .
me . . . . . # .
# . . . . . # .
. # . S . . # .
# . . # . . # .
m . # L # . # .